1111111111
1P000000C1
1000010001
100C010001
1000010001
10C0000001
1000010001
10000100E1
1C00000001
1111111111